#max_provinces = 1466
definitions = "definition.csv"
provinces = "provinces.png"
#positions = "positions.txt"
rivers = "rivers.png"
#terrain_definition = "terrain.txt"
topology = "heightmap.heightmap"
#tree_definition = "trees.bmp"
continent = "continent.txt"
adjacencies = "adjacencies.csv"
#climate = "climate.txt"
island_region = "island_region.txt"
geographical_region = "geographical_region.txt"
seasons = "seasons.txt"

#############
# SEA ZONES
#############
sea_zones = LIST { 
	1292 1293 1294 1295 1296 1297 1298 1299 1300 1301 1302 1303 1304 1305 1307 1308 1309 1310 1311
	1312 1313 1314 1315 1316 1317 1328 1329 1330 1331 1332 1333 1334 1335 1336 1337 1338 1339 1340 1341 1342 1343 1344 1345 1346 
	1347 1348 1349 1350 1351 1352 1353 1354 1355 1356 1357 1358 1359 1360 1361 1362 1363 1364 1365 1366 1367 1368 1369 1372 1373 
	1374 1375 1376 1377 1378 1379 1380 1381 1382 1383 1384 1385 1386 1387 1388 1389 1390 1391 1392 1393 1394 1395 1397 1398 1399 
	1400 1401 1402 1403 1404 1405 1406 1407 1408 1409 1410 1411 1412 1413 1414 1415 1416 1417 1418 1419 1420 1421 1422 1423 1424 
	1425 1426 1427 1428 1429 1430 1431 1432 1433 1434 1435 1437 1438 1439 1440 1441 1442 1443 1444 1445 1446 1447 1448 1449 1450 
	1451 1452 1453 1454 1455 1456 1457 1458 1459 1460 1461 1462 1463 1464 1465 1466 1467 1468 1469 1513 1514 1515 1517 1522 
	1527 1528 1529 1530 1531 1532 1533 1534 1535 1536 1537 1538 1539 1540 1541 1542 1543 1544 1545 1546 1547 1548 1549 1550 
	1551 1552 1553 1554 1555 1556 1557 1558 1559 1560 1561 1563 1564 1565 1566 1577 1579 1581 1584 1585 1586 1587 1588 
	1589 1590 1591 1592 1593 1594 1595 1596 1597 1598 1599 1600 1601 1602 1603 1604 1605 1606 1607 1608 1609 1611 1612 1613 
	1614 1615 1616 1617 1618 1619 1620 1621 1622 1623 1624 1625 1626 1627 1628 1629 1630 1631 1632 1633 1634 1635 1636 1637 1638 
	1639 1640 1641 1642 1643 1644 1645 1646 1647 1666 1667 1668 1669 1670 1671 1672 1673 1674 1675 1676 1677 1679 1680 1681 
	1683 1684 1685 1686 1687 1688 1691 1692 1693 1694 1695 1696 1697 1698 1699 1700 1701 1702 1703 1704 1705 1706 1707 1708 
	1709 1710 1711 1712 1713 1714 1715 1716 1717 1718 1719 1720 1721 1722 1723 1724 1725 1726 1727 1728 1729 1730 1731 1732 1733 
	1734 1735 1736 1737 1738 1739 1740 1741 1975 1980

	#Additions
	6833 6834 6835 6836 6837 6838 6839 6840 6841 6842 6843 6844 6845 6846 6847 6848 6849
	6850 6851 6852 6853 6854 6855 6856 6865 6866 6867 6868 6869 6870 6871 6872 6873 6874 6875 6876 6877 6878 6879 6880 6881 6882
	6883 6884 6885 6886 6887 6888 6889 6890 6891 6892 6893 6894 6895 6896 6897 6898 6899 6900 6901 6902 6903 6904 6905 6906 6907
	6908 6909 6910 6911 6912 6913 6914 6915 6916 6917 6918 6919 6920 6921 6922 6923 6924 6925 6926 6927 6928 6929 6930 6931 6932
	6933 6934 6935 6936 6937 6938 6939 6940 6941 6942 6943 6944 6945 6946 6947 6948 6949 6950 6951 6952 6953 6954 6955 6956 6957
	6958 6959 6960 6961 6962 6963 6964 6965 6966 6967 6968 6969 6970 6971 6972 6973 6974 6975 6976 6977 6978 6979 6980 6981 6982
	6983 6984 6985 6986 6987 6988 6989 6990 6991 6992 6993 6994 6995 6996 6997 6998 6999 7000 7001 7002 7003 7004 7005 7006 7007
	7008 7009 7010 7011 7012 7013 7014 7015 7016 7017 7018 7019 7020 7021 7022 7023 7024 7025 7026 7027 7028 7029 7030 7031 7032
	7033 7034 7035 7036 7037 7038 7039 7040 7041 7042 7043 7044 7045 7046 7047 7048 7049 7050 7051 7052 7053 7054 7055 7056 7057
	7058 7059 7060 7061 7062 7063 7064 7065 7066 7067 7068 7069 7070 7071 7072 7073 7074 7075 7076 7077 7078 7079 7080 7081 7082
	7083 7084 7085 7086 7087 7088 7089 7090 7091 7092 7093 7094 7095 7096 7097 7098 7099 7100 7101 7102 7103 7104 7105 7106 7107
	7108 7109 7110 7111 7112 7113 7114 7115 7116 7117 7118 7119 7120 7121 7122 7123 7124 7125 7126 7127 7128 7129 7130 7131 7132
	7133 7134 7135 7136 7137 7138 7139 7140 7141 7142 7143 7144 7145 7146 7147 7148 7149 7150 7151 7152 7153 7154 7155 7156 7157
	7158 7159 7160 7161 7162 7163 7164 7165 7166 7167 7168 7169 7170 7171 7172
}

###############
# MAJOR RIVERS
###############

########
# LAKES
########
lakes = LIST { 
	1250 1251 1260 1261 1262 1327 1562 1648 1649 1651 1653 1654 1659 1660 1661 1662 1663 1665
	1883 1884 1885 1886 1887 1888 1889 1890 1891 1892 1893 1894 1895 1896 1897 1898 1899 1900
	1902 1903 1904 1905 1907 1908 1909 1910 1911 1913 1915 1916 1917 1918 1919 1920 1921 1922
	1923 1924 1926 1927 1928 1929 1932 1976 1977 2000 2001 4138 6857 6858 6859 6860 6861 6862
	6863 6864 3021 1056 1906 1912 1944 2205 2376 2976 4867 1914 3203 3691 3776 3817

	#Additions
	7173 7174 7175 7176 7177 7178 7179 7180 7181 7182 7183 7184 7185 7186 7187 7188 7189 7190
	7191 7192 7193 7194 7195 7196 7197 7198 7199 7200 7201 7202 7203 7204 7205 7206 7207 7208
	7209 7210 7211 7212 7213 7214 7215 7216 7217 7218 7219 7220 7221 7222 7223 7224 7225 7226
	7227 7228 7229 7230 7231 7232 7233 7234 7235 7236 7237 7238 7239 7240 7241 7242 7243 7244
	7245 7246 7247 7248 7249 7250 7251 7252 7253 7254 7255 7256 7257 7258 7259 7260 7261 7262
	7263 7264 7265 7266 7267 7268 7269 7270 7271 7272 7273 7274 7275 7276 7277 7278 7279 7280
	7281 7282 7283 7284 7285 7286 7287 7288 7289 7290 7291 7292 7293 7294 7295 7296 7297 7298
	7299

	#Additions2
	1319 1320 1321 1322 1323 1324 1325 1326 1470 1471 1472 1473 1474 1475 1476 1477 1478 1479
	1480 1481 1482 1483 1484 1485 1486 1487 1488 1489 1490 1491 1492 1493 1494 1495 1496 1497
	1498 1499 1500 1501 1502 1503 1504 1505 1506 1507 1508 1509 1510 1511 1512 1516 1518 1519
	1520 1521 1523 1524 1525 1526 1610 1650 1652 1655 1656 1657 1658 1664 1678 1682 5361 5279

	
}
lakes = RANGE { 8738 8822 } #Rework

#####################
# IMPASSABLE TERRAIN
#####################
# Can be colored by whoever owns the most of the province's neighbours.
# Blocks unit movement.

############
# WASTELAND
############
# These are actually supposed to be Wasteland:
# Cannot be colored. Blocks unit movement, used for things like Sahara desert. 
impassable_mountains = LIST {
	101 174 176 187 205 505 518 569 687 725 734 763 794 886 960 967 971 990 993 998 999 1002 1003 1004 1005 
    1010 1122 1144 1163 1240 1562 1568 1569 1570 1571 1572 1573 1574 1575 1576 1578 1580 1582 1583 1763 1819 
    1992 2012 2013 2028 2057 2076 2079 2084 2090 2093 2114 2185 2271 2402 2456 2561 2563 2588 2594 2743 2907 
    2942 2970 3022 3023 3024 3025 3146 3147 3148 3149 3150 3151 3152 3153 3154 3155 3156 3157 3158 3159 3160 
    3161 3162 3163 3164 3165 3166 3167 3168 3169 3170 3171 3172 3173 3174 3175 3176 3177 3178 3179 3180 3181 
    3182 3183 3185 3186 3187 3188 3189 3193 3198 3199 3201 3215 3216 3217 3219 3220 3221 3223 3224 3225 3226 
    3227 3228 3229 3230 3231 3232 3233 3234 3235 3236 3237 3238 3399 3400 3401 3402 3403 3404 3405 3406 3407 
    3408 3409 3410 3411 3412 3413 3414 3430 3431 3440 3441 3442 3443 3444 3445 3485 3486 3487 3521 3527 3538 
    3590 3655 3656 3657 3982 3983 3984 3985 3986 3987 3988 3989 3990 3991 3992 3993 3994 3995 3996 3997 3998 
    3999 4000 4001 4002 4003 4004 4005 4006 4007 4008 4009 4010 4011 4012 4013 4014 4015 4016 4017 4018 4019 
    4097 4137 4139 4140 4141 4142 4143 4144 4145 4146 4147 4148 4149 4150 4151 4152 4153 4154 4155 4156 4157
    4158 4159 4160 4161 4162 4163 4164 4165 4166 4167 4168 4169 4170 4171 4172 4202 4203 4204 4205 4206 4207
    4208 4209 4210 4211 4212 4213 4214 4215 4216 4217 4218 4219 4220 4221 4222 4223 4224 4481 4482 4483 4484
    4546 4588 5208 5310 5434 1426 4869 4875 4879 5163 5164 5165 5166 5192 5278 5386 5539 5930 4225 4226
    4228 4229 4231 4232 4233 4234 1567

	#Rework
	10574 10826 10569 10570 10571 10572 10573
}
impassable_mountains = RANGE { 10564 10620 }

# IMPASSABLE SEA ZONES
# These sea provinces cannot be crossed/sailed

# UNUSED PROVINCES
# These provinces cause issues because they are passable land, but not part of any title.
# They are probably not visible anywhere on the map, so feel free to reuse them (after double checking that they are actually missing).